22222222222222222222222222222222222222222222222222222222222222222
2...2...........................................................2
2...2................................OT.........................2
2...2.................................OO........................2
2...2...............................OOOO........................2
2...2...........................................................2
2...222222222222222222..........................................2
2...............................................................2
2................................22.............................2
2222222222222222222222...........22.............................2
2...............................................................2
2................................222............................2
2................................2T2............................2
2................................222............................2
2...............................................................2
2...............................................................2
2...............................................................2
2...............................................................2
2...............................................................2
2...............................................................2
2...............................................................2
2..................................2222222222222222PP222222222222
2..................................2............................2
2..................................2............................2
2.............................B....2............................2
2..................................2............................2
2..................................2............................2
2..................................2...........................S2
2............2222222222222222222222222222222222222222222222222222
2............2
2............2
2............2
22222222222222
